~~~~.....~...~~
~~~~.CCC.~.s.~~
~~~~.........~~
~~~~~.SSSS.~~..
~~~~~......~~.s
...~~~.DD.~~~..
.s.~~~....~~~~~
...~~~~~~~.....
~~~~~~~~~~.CCC.
~~~~~~~~~~.....
~~~~~~~~~...~~~
~~....~~~.s.~~~
~~.DD.~~~......
~~....~~~~~.CCC
~~~~~~~~~~~....
